A batterij zwak	Geen kracht meer
A blub ya!	Hou je bek!
A boeng	Goed (het is)
A boi	Jongeman
A dobbo!	Donder op!
A jonkie	Junk (een)
A jump	Vechtpartij
A mang echt	Hij is goed
A mos!	Hé gozer!
A saḥbi	Vriend
A sma spang	Ze is lekker
A zwempie	Sukkel
Aaai	Oké
Aaboo	Niet echt belangrijk
Aaight	Oké dan
Aaigo	Het gaat wel
Aait	Wreed
Aaker	Saai
Aanpappen	Flirten
Aanstoekoe	Aansteker
Aarsbanaan	Sukkel
Aarshoofdbatser	Eikel
Aas	Gierigaard
Aata	Sukkels
AA-town	Haarlem
Abandjana!	Donder op!
Abbe	Vader
Abbedie	Buitenlander
Abbo	Abonnement
Abbuhalen	Later
ABC-er	Amsterdamse beroepscrimineel
Abdal	Leeg hoofd
Abdi	Malloot
Abee	Vriend
Abi	Broer
Abie	Kerel
Adham	Player
Affoe	Laatste hijsje van een sigaret
Afoe	Beetje
Afoe	Half
Afoe	Trekje
Aftanken	Veel drinken
Aftjappen	Afhouden
Agga	Den Haag
Aight	Beter
Aight	Goed
Aightz	Goed
Aightz	Oké
Air bags	Borsten (grote)
Airbags	Borsten (grote)
Aks	Vraag
Alles chill?	Alles goed?
Alli	Almere
Amo	Amersfoort
Ams	Meisje
Ankeren	Vrijen
Anoe	Hand
Anoesaj	Oh nee he
Anoeska	Masturberen (man)
Anti	Antilliaan
Anyway	Maar ja
Apa kabar?	Hoe gaat het?
Appa	Dronken
Appie	Albert Heijn
A-relax	Niet fijn
Armo	Armeen
Asie	Hasj
Assie	Hasj
A-town	Amerongen
Atta	Friet
Atti	Pet
A-veen	Amstelveen
Baafen	Blowen
Baba	Godfather
Baby boe	Liefje
Babylon	Politie
Bai kas	Naar huis
Baik	Goed
Bajes	Gevangenis
Bakaptaka	Vrijen (van achteren)
Bakka	Klap
Bakkeluloe	Hasj
Bakmeel	Coke
Bakra	Nederlander
Bakroe	Kwade geest
Balanda	Nederland
Balizie	Politie
Ballen	Vrijen
Ballie pattas	Voetbalschoen
Balu	Shit zeg
Balu?	Waarom dan?
Banamba	Dans
Bananas	Hip
Bananas	Modern
Bangsa	Volk
Baniz	Goed
Bankoe	Vijftig euro
Bantie	Dronken
Barew	Hoi
Barkie	Honderd euro
Batas	Schoenen
Batten	Slaan
Bazon	Nietsgunner
Bazz	Hasj
B-boy	Breakdancer
B-Boys	Toffe jongens
Beatrix	Euro
Beckenbauer	Iemand met een opvallend brede mond
Beef	Ruzie
Beemer	BMW
Beest	Goed
BEMPI	BMW
Ben je lauw?	Ben je gek?
Bengschede	Enschede
Benoekoe	Beneden
Benzibox	Autoradio
Beren	Aanklagen
Beveri	Beverwaard
Biatch	Bitch
Biatch	Kreng
Bibi Binzi	Mercedes
Bierie	Bier
Bigi anu	Baas (d)
Bigi fasi	Kapsones
Bijgogem	Bijdehandje
Bika	Fiets
Bikoe	Fiets
Billenmattie	Beste vriend
Bimre	Bijlmer
Bims	Bijlmer
Bitch	Kreng
Bla	Bullshit
Blackatoly	Waterpistool
Blanda	Nederlands
Blaster	Geweer
Blauw	Politie
Blazen	Roken
Blemmen	Verraden
Bling bin	Juwelen
Blok	Sukkel
Blood	Vriend
Blunt	Joint
Bo slecta	Goede plaat
Bobs	Borsten
Boeëreleute	Flauwe humor
Boega	Oké is goed
Boeken	Hard rijden
Boeken	Rijden
Boeken	Wegrennen
Boeler	Homo
Boeloe	Gek
Boeng	Goed
Boeshoem	Stinkende persoon
Bokonko geven	Iemand in elkaar slaan
Boks	Hand geven
Bolletje	Dik persoon
Bon	Goed
Boneles	Slappeling
Bonken	Gooien
Booka	Respect
Boren	Liegen
Bossen	Slaan
Bossie	Kus
Bounty	Een zwarte die zich wit gedraagt
Boycot	Laten
Brada	Broe(de)r
Brada	Vriend
Bradaz	Vrienden
Brainwash	Gek
Brakka	Broek
Brakka	Inbraak
Brasa	Omhelzen
Breeka	Aansteker
Breetie	Blij
Brentje	Nieuw
Brikka	Aansteker
Broeia	Boos
Broeia	Moeilijk
Broenoe	Bruin
Broenoe	Heroïne
Brokken	Iemand standje geven
Broodje	Dik persoon
Broski	Broe(de)r
Bruya	Opgefokt
Buit	Geld
Cala boca!	Hou je mond?
Capish?	Begrepen?
Centje	Centraal Station
Challa	Tot ziens
Challas	Doei
Chan chan	Billen
Cheese	Geld
Chick	Meisje
Chick(ie)	Meisje
Chickie	Lekker ding
Chickie	Meisje (mooi)
Chicky	Meisje (mooi)
Chiemi	Kreng
Chieren	Slaan
Chigga	Chinees die zich als zwarte voordoet
Chikie	Meisje (mooi)
Chillen	Relaxen
Chillen	Rondhangen
Chimeid	Meisje
Chimeid	Meisje (mooi)
Chimeid	Vriendin
Chiney	Chinees
Ching chawa	Kwartje
Chinoe	Chinees
Chioeka	Slet
Choken	Blowen
Choppen	Vrijen
Chronic	Hasj
Click	Gang
Click	Groep
Come again	Herhaling
Commadant	Agent
Como esta?	Hoe gaat het?
Compadre	Kameraad
Condoekoe	Conducteur
Conjo	Kut
Conjo	Vagina
Conta?	Hoe gaat het?
Coulie	Gek
Crêmtje	IJsje
Curva	Meisje (mooi)
Cutty ranks	Wegwezen
Cuty	Meisje (mooi)
Da bomb	Het einde
Da don	Ik ben rijk
Daabse	Mongool
Dagga	Slapen
Daggoe	Hond
Dagoe	Hond
Dalijk	Straks
Dampoe	Scheet
Dampoe	Stank
Damsco Noord Side	Amsterdam-Noord
Damsko	Amsterdam
Dang	Straat
Debiel	Gek
Dede	Dood
Dede	Saai
Deisje	Rustig aan
Der af	Dronken
Derm	Mooi
Diddih	Dood
Dieken	Bemoeien
Dissen	Niet respectvol behandelen
Dissen	Voor aap zetten
Djaai	Negeeractie
Djaffen	Opscheppen
Djalla	Klant
Djie	Jongen
Djoeka	Aap
Djoeke	Steken
Djonko	Joint
Do	Geld
Doedoe	Mama
Doekoe	Geld
Doekoeloos	Geen geld
Doeshi	Schatje
Doezoe	Duizend euro
Dokken	Neergaan
Dolloise	Penis
Donnie	Tien euro
Doos	Vagina
Dope	Cool
Dope	Stoer
Dottie	Vies
Drerries	Broe(der)s
Drerries	Jongens
Droengoe	Dronken
Droog	Nep
Droppa	Dropbox
Droppen	Overvallen
Duhhh	Natuurlijk
Duhhh	Oud nieuws
Dummi	Gekkie
Dushi	Schatje
Dusji	Schatje
Dyna	Gruwelijk
Eindscko	Eindhoven
Etje	Sigaret
Ewa	Héé!
Ewa	Hey
Ewa	Hoi
Ey beter hou je (je) bek!	Houd onmiddellijk je mond dicht!
Ey man!	Hé gozer!
Fa’ka?	Hoe gaat het?
Fa2	Grapje
Fack af!	Houd je mond!
Facka	Geïrriteerd
Faja	Erg
Faja	Heel erg
Faja	Hot
Faja	Moeilijk
Faja	Zielig
Faka?	Alles goed?
Fake	Nep
Fakka?	Hoe gaat het?
Fakkel	Joint
Famiri	Gezin
Fassen	Aanraken
Fatoe	Grapje
Fatoe	Onzin
Fattoe	Grapje
Fawaka?	Alles goed?
Fawaka?	Hoe gaat het?
Faya	Vuur
Fesa	Feest
Feune	Hangen
Fissa	Feest
Fittie	Ruzie
Fitty	Vechten
Five ‘O	Politie
Flaka a tori	In de gaten houden
Flappie	Schatje
Flashen	In de maling nemen
Flex	Cool
Flex	Relax
Floes	Geld
Flokker op!	Donder op!
Flowa	Weggaan
Flowen	Versieren
Flutse	Mislukking
Fly	Cool
Fly	Knap
Flygirls	Meisje (mooi)
Fnitan?	Of niet dan?
Fo sho	Echt waar
Foeroe	Cool
Fok op	Vervelend
Fok op!	Ga weg!
Fonna	Mobieltje
For real	Echt waar
Fotto	Stad
Franco	Geld
Freak	Mafkees
Freeze	Blijf staan
Fromoe	Schiet op
Fucker	Klootzak
G	Meisje
Ga das!	Ga weg!
Ga loesoe!	Ga weg!
Gang	Bende
Ganga	Gruwelijk
Gangster	Stoere gast
Gannoe	Geweer
Ganoe	Geweert
Gardasj	Vriend
Gawi	Auto
Gedane zaak	Sletje
Gejenst	Gefopt
Gelakt	Betaald
Gerro	Sigaret
Gezze	Zeggen
Gi wan pingi	Geef een seintje
Gila	Euro
Giorgo	Man (de)
Ǧnoen	Gek
Ǧnoen	Hoofdpijn
Ǧnoen	Irritatie
Goldie	Aantrekkelijke vrouw
Goons	Gabbers
Goons	Straatsoldaten
Goud	Cool
Gramma	Oma
Grampa	Opa
Gratie	Wegwezen
Gravy	Cool
Griedie	Gierig
Grill	Gezicht
Groen	Wiet
Groene	Joint
Grontjie	Groningen
Gruwelijk	Moeilijk
Guap	Geld
Ǧwanat	Joint
Gymma	Sportschool
Haar a dang	Weggaan
Habibi	Liefje
Hadihoi	Hallo
Ham gaan	Los gaan
Hard	Vies
Hari	Masturberen (man)
He santi	Hoogezand
Hebimento	Geweldig
Herk	Sterk
Het doet	Cool
Het klapt	Het gaat goed
Hip	Stoer
Hizz	Slet
Hodeer niet	Verveel niet
Hoesoe	Huis
Holla	Tot ziens
Holler	Nu meteen
Hoofd	Fellatio
Hopy	Veel
Hosselen	Versieren
How’s life?	Hoe gaat het?
Ibahas	Politie
Ibeεash	Politie
Icecreaman	Dealer
Idi	Hoofd
Ie weinig	Je bent waardeloos
Iǧǧen	Een
Ik ga loessoe	Ik ga (ervandoor)
Ik word para	Ik word gek
Ill	Tof
Illest	Gaafst
In de flow zijn	In de beginfase van een relatie zijn
Inter	Boeiend
Inter	Cool
Ippa geven	Fellatio
Ippie	Politie
Jamma	Pispaal
Janken	Huilen
Jeh grabbing	Snappie?
Jiggy	Cool
Jilla	Gevangenis
Jirp	Tip
Jo	Hoi
Joepen	Vrijen
Joinen	Mee gaan
Joinen	Ondersteunen
Joint	Dik persoon
Joke	Grapje
Jonko	Joint
Joppe	Werken
Ju e lauw?	Ben je gek?
Juten	Politie
Juwelen	Geld
Kaaskop	Nederlander
Kabel	Vriend
Kaboela	Surinaamse muziek
Kaḥbe	Slet
Kaise?	Hoe gaat het?
Kampung	Rosse buurt
Kanen	Eten
Kantelen	Stelen
Kaolo	Kontgat
Kapot	Lelijk
Kappie	Kapsones
Kardash	Maatje
Kardash	Makker
Karsdash	Vriend
Karta	Kaart
Kas gaan	Weggaan
Kassis	Hasj
Kawed!	Donder op!
Kech	Hoer
Kech	Kreng
Keh!	Kom!
Keihard	Geweldig
Keten	Stelen
Keti	Ketting
Kiefen	Blowen
Kieren	Eten
Kieren	Vrijen
Kiet	Gepakt
Kiet	Gestolen
Kifesh?	Hoe?
Kifesh?	Hoezo?
Kifesh?	Waarom?
Kikiriekie	Lelijk
Kill	Gap
Kill	Jongen
Kill	Kerel
Kill	Man
Kino	Film
Kisengmooi	Goed voor je
Kittie	Aansteker
Klari	Vrijen
Klef	Cool
Kloppen	Masturberen (man)
Knopje	Leuk
Knul	Gozer
Koeli	Hulpje
Koenis	Gierigaard
Kon ta bei?	Hoe gaat het?
Koolio	Toffe gast
Kop	Duizend euro
Korroe	Lelijk
Koullo	Vriend
Kraktisupu	Krachtsoep
Kranka	Gek
Krasbal	SOA
Krasi	Geil
Krentebol	Dik persoon
Krossies	Kleren
Kush	Joint
Kuta	Hond
Kwaka	Leuk
Kwarktassen	Borsten
Kwekku	Praten
La Rouge	Bende (een)
Laf ya	Ik hou van je
Laffoe	Lachen
Lagi	Laag
Lakie	Joint
Lakoenza	Geld
Lala	Cocaïne (rauw)
Lala	Wit (rauw)
Lappie	Laptop
Laterz	Tot later!
LaterZzz	Tot ziens
Latra	Tot ziens
Lauw	Goed
Lauw	Mooi
Lauw	Relaxed
Lauw	Te erg
Lebben	Bellen
Legualeza	Iemand die veel weet en uitlegt
Leḥnash	Politie
Leḥnash	Slang
Leipe frea	Idioot
Lekka lek	Meisje (mooi)
Lekker doen	Iemand die interessant loopt te doen
Lemma	Haarlem
Libieloos	Levenloos
Lidorro	Leiderdorp
Lijn 11	Lopen
Likecind	Vriendelijk
Liptenays	Lippen
Lit	Aan
Lit	Gezellig
Liti	Licht
Litta	Aansteker
Litti	Aansteker
Loco	Nadenken
Loco	Trein
Loent	Cool
Loesoe	Weg
Loesoe	Weggaan
Loos	Dom
Loos	Lomp
Lotto	Vijf euro
Lyrics	Songteksten
Ma crib	Huis
Ma pampang	Mijn bil
Ma shit	Mijn zaakjes
Macfees	Mafkees
Maddish	Helemaal maf
Mang	Of niet
Marijuana	Wiet
Mastah	Baas (de)
Masten	Masturberen (man)
Master	Meesterlijk
Master swa	Mister cool
Masterdam	Amsterdam
Masterlijk	Cool
Matie	Vriend
Matsko	Gap
Matsko	Vriend
Matten	Vechten
Mattie	Vriend
Matties	Vrienden
Maεlish	Maakt niet uit
Maεlish!	Laat maar!
Mentos	Ongesteld
Merrie	Mercedes
Method	Hasj
Meti	Vlees
Mi abi spier	Erectie
Mi de	Het gaat
Mi gaddo	Mijn god
Mi goedoe	Mijn schatje
Mi lob you	Ik hou van je
Mi lobo joe	Ik houd van je
Millie	Miljoen euro
Mitti	Meid
Mitti	Meisje
Mo money	Meer geld
Mobila	Mobieltje
Mocro	Marokkaan
Moer	Moeder
Moesoe	Muis
Moffo	Mond
Mokkel	Meisje (mooi)
Mokro	Marokkaan
Mongol	Gek
Morajka	Meisje (mooi)
Mos	Gozer
Mos	Jongen
Motjo	Hoer
Motta	Hasj
Motu	Papzak
Mula	Geld
Mulut	Mond
Musa	Geld
Nacken	Slaan
Nafnoe	Kusje
Naki wan inter	Belazeren
Nakio	Donkere jongen
Nakken	Stelen
Nakken!	Ophouden!
Nakkoe	Niks
Nan da yo	Wat moet je?
Narren	Iemand vervelen
Nasty	Vies
Netjes	Goed zo
Nieges	Ongeluk
Niffauw	Neef
Niffauw	Vriend
Niffow	Neef
Nifo	Neef
Nigga	Neger
Nigga	Vriend (jouw)
Nikka	Vriend (jouw)
Nivi	Mes
Njang mi m	Kus m’n achterwerk
No badda	Geen zorgen
No mang	Nee man
No spang	Geen zorgen
Nogro	Racist
Normoelulu	Normaal
Nosso	Neus
Oefoe	Overval
Oekoe	Hoek
Oema	Meisje
Oetoe	Sukkel
Offie	Politie
Ok ga pia	Ik ga (ervandoor)
Oldies	Oude mensen
Ollo	Feest
Ollo	Gat
Ommin	Te erg
On te bont	Cool
One	Tot ziens
Onmin	Heel erg
Onyx	Cool
Op een feest boren	Zonder uitnodiging op feest
Opjenssen	Oprotten
Oplossen	Weggaan
Ordes	In orde
Oso	Huis
Oso cee	Naar huis
Osso	Huis
O’tje	Xtc-pil
Outka	Utrecht
Ouwe	Vriend
Ov’tje	Overval
Pagga slaan	Masturberen (man)
Paiso	Betalen
Pakkies	Pak slaag
Palla	Nep
Palla	Niet waar
Palla	Onzin
Panja	Cool
Panja	Dronken
Panna	Dronken
Panne	Hasj
Pantat	Kont
Paopa	Goede eter
Paopa	Vriend
Pape	Vriend
Papfles	Hij/zij is niks waard
Para	Gek (maken)
Para	Kapot
Paroe	Ouders
Pataaaat	Shit zeg
Pata’s	Schoenen
Pattas	Schoenen
Peepz	Ganster
Pekie	Vriendin
Perkie	Xtx-pil
Pezavenk	Pooier
Phat	Cool
Pia	Weggaan
Pieltrekken	Masturberen (man)
Pienaren	Arm zijn
Pierie tiefie	Lachen
Pikaan	Weggaan
Pila	Dronken
Pipa	Joint
Pipa	Pistool
Piraat	Somaliër
Pisang	Plassen
Pit	Joint
Pitt	Hasj
Plaeze	Alstublieft
Planga	Bril
Plangas	Zonnebril
Plastic	Credit card
Playa	Pooier
Player	Casanova
Pletzen	Plaatsen
Pocket	Mobieltje
Poeni	Vagina
Poenta	Vagina
Poeny	Vagina
Poes	Vagina
Poese	Vagina
Pokkoe	Liedje
Pokoe	Liedje
Pokoe	Muziek
Pokoes	Songs
Popo	Politie
Porfoto	Rotterdam
Porie	Nep
Portjie	Mobieltje
Pot	Lesbo
Prakseri	Denken
Prikka	Goede prijs
Prikken	Vrijen
Pro-beren	Profiteren
Proeka	Pruik
Qaḥbe	Slet
Qlawi	Balzak
Qowwed!	Donder op!
Rais tha	Feesten tot
Rampa	Gevecht
Reetlikker	Klootzak
Relaxed	Rustig
Remi	Alleen
Ride	Auto
Riden	Chillen
Rippen	Stelen
Rocken	Dragen
Roffa	Rotterdam
Roffadam	Rotterdam
Rug	Duizend euro
Saen-Boogie-Dam	Zaandam
Sagbi	Vriend
Saja luku!	Hou je mond!
Salaam	Hallo
Samsa?	Wat is er?
Sanchi	Vagina
Sang	Ongelooflijk
Sang	Zo
Sani	Ding (een)
Sanka	Bil
Sappen	Stelen
Sappen	Stelen
Sappiemang	Gekke man
Sappig	Lekker
Scaffa	Gek
Scandi	Erg
Scandoules	Schandalig
Scava	Stoned
Scheer	Leeg
Scherp	Intelligent
Schotten	Afzeiken
Schuren	Schudden
Schuren	Tegenaan drukken
Schuren	Wassen
Scoebaas	Schoenen
Scooba	Scooter
Scooby	Scooter
Scorro	School
Scotoe	Politie
Scotten	Negeren
Scouto	Politie
Scrap	Dood
Scribboe	Schrift
Scrilla	Geld
Scumbag	Stom
Shaker	Verwarrend
Shantan	Snel
Shenk	Mes
Shibber	Waardeloos
Shock	Stoot
Shoebas	Schoenen
Shoppa	Coffeeshop
Sickie	Je bent gek
Siki	Cool
Sisa	Zus
Six feet	Dood
Sjakie	Sukkel
Sjenk	Mes
Sjenken	Steken
Sjig	Leugen
Sjikiman	Stom
Sjing	Schande
Skaatje	Schatje
Skaffa	Stoned
Skatten	Vrijen
Skaveren	Eten
Skeamen	Loeren
Skeemen	Spieken
Skeer	Arm
Skeer	Blut
Sketten	Borsten
Skevie	Scheveningen
Skiddy	Liefje
Skidy	Lief
Skiffy	Scheveningen
Skinny	Mager
Skippen	spijbelen
Skitmo	Schijt aan
Skitta	Schijt aan
Skootoe	Politieagent
Skoro	School
Skotoe	Politie
Skraal	Oneerlijk
Skraffa	Cool
Skrieki	Schrikken
Slanging	Dealen
Sloerie	Slet
Sma	Meisje
Smatje	Meisje
Smatje	Schatje
Smocho	Je bent erg
Smoe	Roken
Smoke	Roken
Smoken	Blowen
Smooth	Cool
Snaak	Joint
Snaap	Vreemd
Snaapse lik	Vreemde persoon
Snagga	Sigaret
Snitch	Verrader
Soema	Wie
Soetoe	Hijsje
Soetoe	Roken (joint)
Soetoe	Roken (sigaret)
Soetoe	Trekje
Soma	Dun persoon
Soma	Somaliër
Soppie	Drinken
Sosa	Cocaïne
Sosaa	Cocaïne
Spacen	Dom doen
Spang	Lekker
Spange	Lekker
Spange chick	Meisje (mooi)
Spange chick	Meisje (mooi)
Spebbe	Dik persoon
Spieren	Erectie
Spiffy	Cool
Spijker	Gierig
Spliff	Joint
Splitten	Wegwezen
Spopo	Spoorwegpolitie
Spuiter	Gangmaker
Sranang	Suriname
Stacks	Geld
Stamang	Kabel
Stamma	Vriend
Standaard	Vanzelfsprekend
Stanko	Vriend
Stibbi	Erectie
Stiffa	Erectie
Stigga	Steeg
Stikri	Aansteker
Stilo	Mode
Stinna	Steen
Stof	Hasj
Stof	Wiet
Stofzuigen	Fellatio
Strak	Cool
Strakke poster	Brutaal gezicht
Strano	Raar
Strap	Geweer
Stroggel	Ruzie
Stronken	Stoned en dronken
Stuka	Studeren
Styl	Cool
Styling	Leuk
Suchaaa	Sukkel
Sunchi	Kusje
Sup?	Hoe gaat het?
Swa	Gozer
Swa	Jongen
Swa	Vriend
Swagga	Jongen (mooie)
Swagga boy	Jongen (mooie)
Swagga boy	Mooi boy
Sweetie	Lekker
Ta pie mov!	Hou je mond!
Tabacca	Sigaret
Tabacca	Sigaretten
Taker	Lelijk
Takken	Praten
Takkerheid	Stom
Takkie	Praten
Tan plan	Blijven zitten
Tang	String
Tanga	Meisje
Tanga	Meisje (mooi)
Tantoe	Hard
Tantoe	Heel erg
Tapanahoni	Afsnauwen
Tapen	Kopiëren
Tapen	Nadoen
Tapi movo	Mond dicht
Tapimofo?	Hoe gaat het?
Tappen	Drinken
Tata	Blanke
Tatta	Blanke
Tatta	Hollander
Tatta	Kaasop
Tatta	Nederlander
Tattalands	Nederlands
Tav	Vat
Tchumai	Meisje (mooi)
Telly	Mobieltje
Teringcel	Gevangenis
Tev	Cool
Texel	Tot ziens
Tfoe	Shit
Tha bomb	Beste (de)
Tha Dockz	Rotterdam
Thalla	Tot ziens
Thalla	Tot ziens!
Thuaka	Hallo
Thug	Ganster
Thx	Bedankt
Tikoe	Tilburg
Timer	Even wachten
Tippo	Autoradio
Tjaaring	Streken hebben
Tjading	Leuk
Tjaiba	Hasj
Tjala	Weggaan
Tjallen	Stelen
Tjappa	Eten
Tjappen	Eten
Tjawa	Vijfentwintig euro
Tjollie	Jongen
Tjumai	Meisje (mooi)
Todo-ai	Iemand met opvallend grote ogen
Toektoek	Joint
Toetoemoel	Stil
Tof	Cool
Tokkelen	Versieren
Toli	Penis
Tollen	Draaien
Topen	Beuken
Torie	Ding
Torie	Verhaal
Torie	Zaak
Tralalalala	Vrolijk
Tranga	Cool
Trangaoema	Vrouw (sterke)
Trinnoe	Trein
Tripple X	Amsterdam
Trips	Trippen
True that	Juist
Turkoe	Turk
Twin bradaz	Tweelingbroer
Uang	Geld
Umpielumpie	Fietsband
Undrogron	Onderwereld
Upper K	Bovenkarspel
Uurkoe	Turk
Vegen	Kapot maken
Vegen	Slopen
Vimre	Bijlmer
Vingalinga	Masturberen (vrouw)
Vittie	Vechten
Vlieg	Irritant
Vonk	Leugen
Vootje	Vomar
Vpang	Meisje (mooi)
Vpiekerie	Spijkenisse
Vras	Gierigaard
Vras	Gierigaard
Vroes	Raar
Vuur	Aansteker
Vuur	Aansteker
wachti	Wacht
Waggie	Auto
Waḥed	Een
Wahekella	Ik zweer het op God
Waḥeqellah	Ik zweer het op God
Waka	Gek
Wakka	Lopen
Wakka mang	Player
Wakka mang	Zwerver
Wakka!	Kom we gaan!
Walla	Ik zweer
Walla?	Meen je dat?
Wallah	Zweren
Wandel	Het gaat goed
Wanker	Masturbeerder (man)
Wannabee	Neppe gozer
Wappa	Stoned
Wat doet je moer?	Wat doe je?
Wat is de leeftijd?	Hoe laat is het?
Wat kijk je lang?	Waarom kijk je naar me?
Watskebuurt abi?	Wat is er aan de hand?
Weerie	Raar
Welloe	Geen
Welloe	Niets
Wenker	Masturbeerder (man)
Werhaal	Vergeet het
Wette?	Begrijp je?
Wezebbie	What the fuck?
Whattup	Hoi
Whazzzzzzzzzzza?	Hoe gaat het?
Wholla	Ik zweer het
Wierie	Wiet
Wierrie	Haar
Wierrie	Hasj
Wigga	Wannabe neger
Wigger	Blanke neger
Wippa	Weesp
Wirie	Wiet
Wittie	Heroïne
Wix	Gaaf
Wo box	tot ziens
Woeshoem	Stinkende persoon
Wollah	Ik zweet het
Wollah	Zweren
Wollah meh	Zweer van niet
Word up?	Hoe gaat het?
Wouten	Politie
Wussel	Haarelastiek
Ya bitch	Trut
Yallah!	Kom op!
Ye hossel	Moeite doen
Ye kot vonk	Je bent gevaarlijk bezig
Yo	Hoi
Yo man	Oké dan
Yo tjappie!	Hé gozer!
Yusu	Serieus
Zaad	Sperma
Zemmel	Homo
Zoutig	Lullig
Zuanat	Joint
Zuignoppen	Borsten
Zuur	Nep
Zwaad	Sperma
Zwabber	Luiaard
εandek	Pas op!
εezzie	Zwarte