https://nl.wikisage.org/wiki/Lijst_van_bijnamen_van_steden_en_dorpen
België
Aalst - Ajuinenstad, Carnavalsstad
Antwerpen - Koekenstad, Scheldestad, Sinjorenstad, 't Stad, Diamantstad
Bastenaken - Nuts-city
Beernem - Zorggemeente
Berchem - Slijkdorp
Binche - Carnavalsstad, Gillesstad
Borgerhout - Reuskensdorp
Bouwel - Blarendabbersdorp
Brugge - Venetië van het noorden, Breydelstad
Brussel - hoofdstad, hoofdstad van Europa, Europese stad, Kiekenfrettersstad
Charleroi - Chicago aan de Samber
Diest - Oranjestad
Durbuy - Kleinste stadje ter wereld
Ekeren - Bierpruversdorp
Geel - Barmhartige stad, Zottenstad
Gent - Fiere stad, Arteveldestad, Stroppenstad
Halle - Pierendorp
Hasselt - Jeneverstad
Hoeilaart - Glazen Dorp
Ieper - Kattenstad
Kanegem - Bloemendorp
Kasterlee - Pompoendorp
Kortrijk - Groeningestad, Guldensporenstad
Kuurne - Ezelgemeente
Lanaken - Heksenrijk
Leuven - Bierstad, Bierhoofdstad, Studentenstad
Lier - Pallieterstad, Schapenkoppenstad
Luik - Vurige stede, cité ardente, Palermo aan de Maas
Meerhout - Kattengemeente
Mechelen - Dijlestad, Charleroi aan de Dijle, Maneblussersstad
Merksem - Stroboerendorp
Ninove - Wettelstad
Onze-Lieve-Vrouw-Waver - Torekenswaver, Torekensdorp
Oostende - Koningin der badsteden
Redu - Boekendorp
Roeselare - Rodenbachstad
Schaarbeek - Ezelsgemeente
Sint-Truiden - Fruitstad
Tienen - Suikerstad
Torgny - Provence van België
Turnhout - Kaartenstad, Hoofdstad van de Kempen
Veurne - Boetestad, stad van de slapers
Vilvoorde - Zennestad
Waanrode - Bloemendorp
Waregem - Paardenstad
Wéris - Stonehenge van België
Westerlo - Parel van de Kempen
Wilrijk - Geitendorp
Wingene - Varkensgemeente
Nederland
Aalsmeer - Dubbel A
Alkmaar - Kaasstad, Mokum Aye
Almere - Polderstad, Ally
Alphen aan den Rijn - 0172
Amersfoort - Keistad
Amstelveen - Veentje
Amsterdam - Mokum, Venetië van het Noorden, Mokum Allef, 020, Damsko
Apeldoorn - AP
Arnhem - Rijnstad, Parkstad, Haagje van het oosten, Arra
Baarn - Het Groene Graf
Barneveld - Kippendorp
Bergen - Heerlijkheid
Bergen op Zoom - Krabbegat, Krabbestad, Markiezaatsstad
Breda - Oranjestad, Haagje van het Zuiden, Kielegat
Coevorden - Ganzenstad
Delft - Prinsenstad, Mokum Dollet
Delfzijl - Sicilië aan de Eems, Het einde van de wereld
De Lier - Bukkersgat, Del Jee
Den Haag - Hofstad, Residentie, 't Haagje, Juridische Hoofdstad van de Wereld
Den Helder - Marinestad, Nieuwediep
Deventer - Koekstad, Boekenstad, Moskou aan de IJssel
Dirksland - Stropdassendorp, Klein Parijs
Doesburg - Smerenburg, Mosterdgat
Dordrecht - Dordt, Schapekoppenstad
Eindhoven - Lichtstad, Lampegat
Egmond aan Zee - Derp, Jutterdonk
Emmen - Vlinderstad, Stad van Dorpen
Enkhuizen - Haringstad
Enschede - Pluskut, Krekkelstad
Genemuiden - Tapijtstad, Koolraap City
Goes - Ganzenstad
's-Gravendeel - Seuterdorp, Kildorp
's-Gravenzande - Breeje Durep, 's Gravezooie
Groningen - Stad, Groot Loug, Martinistad, 050
Grijpskerke - Geitendorp
Goirle - Ballefruttersgat
Gouda - Kaasstad
Hardenberg - Bierstad
Haarlem - Spaarnestad
Helmond - Kattenmeppers
's-Hertogenbosch - Den Bosch, Hertogstad, Moerasdraak, Oeteldonk
Hilversum - Omroepstad, Hillywood, Mediastad
Hoek van Holland - De Hoek
Hoorn - Coenstad
Kudelstaart - Kudel
Leerdam - Glasstad
Leiden - Sleutelstad
Lelystad - Lelytown
Lemelerveld - Sukerbietendorp
Maasdijk - De Dijk
Maastricht - Maasstad, Maasje
Meppel - Klein-Rotterdam, Rotterdam aan de Reest
Millingen a/d Rijn - Hart van de Gelderse Poort
Moergestel - Gessel
Naaldwijk - Nalek, Naluk
Numansdorp - Buitensluis
Nijmegen - Havana aan de Waal, Keizerstad, Nimma, Keizer Karelstad, Waalstad, ODW, Over De Waal, Knotsenburg
Oisterwijk - Döllekesgat
Oldenzaal - Boeskoolstad
Oosterend - Jeruzalem van Texel
Oud-Beijerland - Spuidorp
Oss - Chicago aan de Maas
Poeldijk - Poelek, Poellert
Rotterdam - 010, Rotown, Rotjeknor, Mokum Reisj,Havenstad, Wereldhavenstad, Maasstad, Manhattan aan de Maas, Istanboel aan de Maas, Chicago aan de Maas, Roffa
Schagen - Magnusveste, Klein Sjikago
Schiedam - Jeneverstad, Zwart Nazareth, Borreldam
Schoonhoven - Zilverstad
Sint Annaland - Het toverkot
Slagharen - Turfgat
Sliedrecht - Baggerdorp
Spijkenisse - Spikecity
Tilburg - Kruikenstad, Textielstad
Thorn - Witte stad
Utrecht - Domstad, Utereg, Utreg, Utca, Utka, U'tje, 030
Uithoorn - UTH, 0297
Varsseveld - Poggendam
Veendam - Parkstad
Vinkeveen - Vinke City
Vlaardingen - Haringstad
IJzendijke - Petit Paris
Wageningen - Stad der Bevrijding
Weert - Vlaaistad
Werkendam - Vrouwenhemel
Westervoort - Wivva
Woudrichem - Mosterdpot
Wijchen - Centrum in Tweestromenland
Winschoten - Sodom, Mokum Beis, Mokum van het Noorden, Molenstad
Vianen - Reigers
Zandvoort - Amsterdam aan Zee, Zandje
Zeist - Slotstad
Zoetermeer - Sweet Lake City, Zoetje
Zutphen - Torenstad
Zwolle - Zwoffa, Zwollywood, Sassendonk
Frankrijk
Rijsel - Capitale des Flandres
Colmar - Hoofdstad van de Elzaswijnen
Parijs - Lichtstad, Stad der liefde, Panam
Verdun - Wereldhoofdstad van de Vrede
Duitsland
Aken - Printenstad
Berlijn - Spree-Athen, Schnauzenstad
Dresden - Elbflorenz
Keulen - Domstad, Klüngelstad
Koblenz - Confluentes
Italië
Bologna - la Grassa, la Dotta, la Rossa, il Grasso
Florence - la Bella
Genua - la Superba
Milaan - la Grande, modestad
Napels - la Città del Sole
Rome - Stad der zeven heuvels, la città Eterna, de Eeuwige stad, la Santa
Venetië - Lagunestad, Dogestad, la Serenissima
Tsjechië
Praag - Stad van honderd torens, de gouden stad
Pilsen - Bierstad
Spanje
Barcelona - Barna, Ciutat Comtal
Mexico
Cuernavaca - Stad van de eeuwige lente
Guadalajara - Parel van het Westen, Tapatiopolis
Mérida - De witte stad
Mexico-Stad - Chilangolandia
Nuevo Laredo - Narco Laredo
Puebla - Ángelopolis, Stad van de engelen
Verenigd Koninkrijk
Aberdeen - Granite City
Birmingham - Brum, The City of a Thousand Trades
Derry - Stroke City
Londonderry - Stroke City
Liverpool - The Pool of Life, Giro City
Londen - The Big Smoke
Manchester - Rainy City
Middlesbrough - Ironopolis
Newcastle upon Tyne - The Toon
Portsmouth - Pompey
Sheffield - Steel City
Skegness - Skeggy
Skelmersdale - Skem
Verenigde Staten
Boston - Beantown, The Hub
Chicago - The Windy City, Chi-town, The Second City, Chiraq
Dallas - Big D
Denver - The Mile-High City
Detroit - Motown, Iron City, Motortown
Key West - Margaritaville
Las Vegas - Sin City
Los Angeles - LA, City of Angels
New Orleans - The Crescent City, The Big Easy, NOLA
New York City - NY, NYC, The Big Apple, The City That Never Sleeps
Philadelphia - The City of Brotherly Love, Philly
Phoenix - Valley of the Sun
Pittsburgh - Steel Town
St. Louis - Gateway to the West
San Francisco - Frisco, SanFran, The City by the Bay, The Gay City
Washington D.C. - DC, The District, Inside the Beltway
Sacramento - The City of Trees
Maassluis - Sydney aan de Waterweg